1111111111111
10010000C00C1
10P0011111001
10001E0000C01
1111111111111